乃木	乃木
若葉	若葉
園子	園子
三好	三好
夏凜	夏凜
三ノ輪	三ノ輪
銀	銀
上里	上里
ひなた	ひなた
千景	千景
土居	土居
球子	球子
夕海子	夕海子
小園子	小園子
山伏	山伏
しずく	しずく
シズク	シズク
友奈	友奈
天の神	天の神
水都	水都
犬吠埼	犬吠埼
風	風
樹	樹
加賀城	加賀城
雀	雀
古波蔵	古波蔵
棗	棗
白鳥	白鳥
歌野	歌野
伊予島	伊予島
杏	杏
安芸	安芸
真鈴	真鈴
年上園子	年上園子
年下園子	年下園子
亜耶	亜耶
私	私
赤嶺	赤嶺
ゆーゆ	ゆーゆ
国土	国土
弥勒	弥勒
蓮華	蓮華
東郷	東郷
美森	美森
芙蓉	芙蓉
花本	花本
美佳	美佳
芽吹	芽吹
青い烏	青い烏
勇者	勇者
勇者システム	勇者システム
姫	姫
封印の儀	封印の儀
柚木	柚木
秋原	秋原
雪花	雪花
美花	美花
美咲	美咲
美都	美都
俺	俺
桐生	桐生
静	静
神世紀	神世紀
神樹	神樹
郡	郡
高天原	高天原
高嶋	高嶋
御先祖	御先祖
くん	くん
散華	散華
景	景
満開	満開
結城	結城
結城っち	結城っち
須美	須美
園子先生	園子先生
楠	楠
楠芽	楠芽
楠芽吹	楠芽吹
農業王	農業王
僕	僕
精霊	精霊
樹海	樹海
藤森	藤森
藤森水都	藤森水都
鷲尾	鷲尾
鷲尾須美	鷲尾須美
防人	防人